; NON-PLATED HOLES START AT T1
; THROUGH (PLATED) HOLES START AT T100
M48
INCH
T100C0.039370
T101C0.035000
T102C0.040639
T103C0.098425
T104C0.040000
%
T100
X001540Y008591
X001540Y012590
X002540Y008591
X002540Y012590
X003540Y008591
X003540Y012590
X004540Y008591
X004540Y012590
X005540Y008591
X005540Y012590
T101
X005540Y002591
X001540Y015590
X001540Y002591
X005540Y015590
T102
X004540Y000591
X003540Y000591
X002540Y000591
X001540Y000591
X000540Y000591
T103
X005990Y017590
X001040Y017590
T104
X004540Y004591
X002540Y006591
X005540Y004591
X002540Y010590
X003540Y006591
X003540Y010590
X004540Y006591
X004540Y010590
X005540Y006591
X005540Y010590
X002540Y004591
X003540Y004591
T00
M30
